..........W.........
A........######.....
+++++++...1.........
r.........W........X
C.........W......###
+++++++...W.........
..........W........R
..C.......W.........
+++++++...W..W....C.
..........W..+++++++
r..C......W.........
+++++++...W..W.....C
..........W..+++++++
..........W........R
..@@@@@@@@@@@@@@@@..
You are a twat!
