1.5
.............
r....W.......
...@@@.......
..........1..
...@@....@@..
....W........
...@@.......-
.............
r............
.............
.X..A...T....
######..###..
You are a twat!
